****************
*   *          *
* * * * ********
* * * * *   *S*
* * * * * * * *
* * * * * * * *
*E*   *   *   *
****************
